NO ./path_to_the_north_texture
SO ./path_to_the_south_texture
WE ./path_to_the_west_texture
EA ./path_to_the_east_texture
F 220,100,0
C 225,30,0


                11111111
                1111
                   11111111
        1111111111111111111111111
        1000000000110000000000001
        1011000001110000000000001
        1001000000000000000000001
111111111011000001110000000000011
10000000001100000111011111111111111
11110111111111011100000010001111
11110111111111011101010010001
1100000011010101110000001000111
100000000000000011000000100011
1000000000000000110101001000111
11000001110101011111011110N01111
11111111 1111111 111111111111111
                11111111
                1111
                   11111111