NO ./assets/xpm/walls/blue_wall_01.xpm
SO ./assets/xpm/walls/blue_wall_02.xpm
WE ./assets/xpm/walls/blue_wall_02.xpm
EA ./assets/xpm/walls/blue_wall_01.xpm
F 220,100,0
C 225,30,0

1        111111111    1           1
        1111111111111111111111111
        1000000000110000000000001
        1011000001110000000000001
        1001000000000000000000001
111111111011000001110000000000001
10000000001100000111011111111111111
11110111111111011100000010001
11110111111111011101010010001
1100000011010101110000001000111
10000000000000001100000010001
10000000000000001101010010001                         11
11000001110101011111011110N01111                    1 11
11111111 1111111 111111111111111                   1   1
