NO ./path_to_the_north_texture
SO ./path_to_the_south_texture
WE ./path_to_the_west_texture
EA ./path_to_the_east_texture
F 220,100,0
C 225,30,0

111
101
111
                1
                1
                1
                1
                1
        11111111111111111111111111111111
111111111000000000110000000000001
        10110000011100000000000010
111111111001000000000000000000001
111111111011000001110000000000001
100000000011000001110111111111111
11110111111111011100000010001        
11110111111111011101000000001        
11000000110101011100011111001111
1000000000000000110001   1000001
1000000000000000110101   1000001111
11000001110101011111011111N01111
11110111 1110101 101000000001
11111111 1111111 111111111111

if map[16][23] == ' '
{
	map[15][23] != '1' || map[15][24] != '1'
		erro;
}

111
1N1
111

=> wall[LEFT] = 8 ; wall[RIGHT] = 33
=> a posição da wall[LEFT] anterior é igual a posição da wall[LEFT] atual?
=> a posição da wall[RIGHT] anterior é igual a posição da wall[RIGHT] atual?
