NO ./assets/xpm/walls/blue_wall_01.xpm
SO ./assets/xpm/walls/blue_wall_02.xpm
WE ./assets/xpm/walls/blue_wall_02.xpm
EA ./assets/xpm/walls/blue_wall_01.xpm
F 220,100,0
C 225,30,0

111111111
100000001
100000101
10000S101
111111111
