NO ./assets/xpm/walls/blue_wall_01.xpm
SO ./assets/xpm/walls/blue_wall_02.xpm
WE ./assets/xpm/walls/blue_wall_02.xpm
EA ./assets/xpm/walls/blue_wall_01.xpm

F 220,100,0
C 225,30,0

111111111111111111111
100001000000000000001
101000000000000000001
100S00100100100100101
10000000000e000000001
10000010e0e0000000001
111111111111111111111
