NO ./assets/xpm/walls/blue_wall_01.xpm
SO ./assets/xpm/walls/blue_wall_02.xpm
WE ./assets/xpm/walls/blue_wall_02.xpm
EA ./assets/xpm/walls/blue_wall_01.xpm
F 128,128,128
C 222,222,222







        1111111111111111111111111
        1000000000110000000000001
        1011000000110000000000011
111111111001000000000000000000001
111111111011000001110000000000001
100000000011000001110111111111111
11110111111111011100000010001
11110111111111011101000000001
11000000110101011101111111111
10000000010000S0110001   101
100000000D000000110111   101
1000000001000e0e110001   101
11000001110101011111011111011
11110111 1110101 101000000001
11111111 1111101 111111111111
        111111D111111111111111111
        1000000000110000000000001
        1011000000110000000000011
111111111001000000000000000000001
111111111011000001110000000000001
100000000011000001110111111111111
11110111111111011100000010001
11110111111111011101000000001
11000000110101011101111111111
1000000000000000110001   101
1000000000000000110111   101
1000000000000000110001   101
11000001110101011111011111011
11110111 1110101 101000000001
11111111 1111111 111111111111
