NO ./path_to_the_north_texture
SO ./path_to_the_south_texture
WE ./path_to_the_west_texture
EA ./path_to_the_east_texture

F 220,100,0
C 225,30,0

222222222222222
100000000000101
100001000000101
111100000010101
100000000010101
1000000S2222101
100000000000001
100000000000001
111111000111101
100000000000001
333333333333333
