NO ./path_to_the_north_texture
SO ./path_to_the_south_texture
WE ./path_to_the_west_texture
EA ./path_to_the_east_texture

F 220,100,0
C 225,30,0

111111111111111111111
100001000000000000001
101000000000000000001
100S00100100100100101
100000000000000000001
100000100000000000001
111111111111111111111
